11111111111111111111
1CP000000E00000000C1
10000000000000000001
10000000000000000001
10000000000000000001
1C000000000000000HC1
11111111111111111111
