1111111111111111111111111111111111
1P0000000000000E00000C000000000001
1111111111111111111111111111111111
