111111111111111111111111111111
10C0000111111000010C01000H0001
110C00010000C0110010CH100C0001
101101H01000000010010001000001
10000100100C000E0001000110C001
110C1000C000010010H00010000001
1111000010001000H01010100C0101
1100000000001P0000C001000C0011
100C01000000010000011101100001
10000C01000H0001000100C0010101
1100000001000000100HC000011001
110101000100000000000C00011101
11000010H0011110000000C0010011
110C00C00100000001110000000101
110000C00H00000C000H01110C0001
111111111111111111111111111111
