111111111111111
10PC00E00C00001
111111111111111