111111
1001E1
1P0011
1C0001
111111
