111111
1P0E11
100011
1000C1
111111