111111
1001C1
100011
100001
111111
