111111
1P0EC1
100111
1000C1
111111