11111111111111111
10000000000001111
1000E000010000111
1000C000000000011
10000000000000001
100P0000010000001
100000000C0000001
10000000010000001
100010000000C0001
11111111111111111