111111111111111111111111111111
10C0000111111000010C0100000001
110C00010000C0110010C0100C0001
101101001000000010010001000001
10000100100C000E0001000110C001
110C1000C000010010000010000001
1111000010001000001010100C0101
1100000000001P0000C001000C0011
100C01000000010000011101100001
10000C0100000001000100C0010101
11000000010000001000C000011001
110101000100000000000C00011101
1100001000011110000000C0010011
110C00C00100000001110000000101
110000C00000000C000001110C0001
111111111111111111111111111111